1111111
1111111
1111111
1111111
1111111
111EPC1
1111111
