11111111111
10100101111
10101111011
1000P000111
10101111011
11101101011
10001111011
10101011111
11100011011
1C101010001
10000000001
10010000001
10000000001
10001000001
10000000001
10111111111
10000E00001
11111111111
