111111
1000001
100PCE01
100000001
1000000001
11111111111
